6 6
XXXXXX
Xii  @X
XMi  X
X  XXX
Xi  MX
XXXXXX